########
#......#
#......###
#..@.....#
#......###
#<.....#
########